Glulxe fatal error: The game file could not be opened. (/home/jordan/Desktop/onehourgamejam69.inform/Build/output.ulx)

[ The game has finished ]

>look
Study
The study is profoundly clean. I'm very proud of how well kept this room is. The hallway is to the west.

You can see a glass desk (on which are a tiny wooden box (closed) and a monitor) and a computer key here.

>look at desk
This glass desk is completely transparent, and like the room overall, completely free of dust.

On the glass desk is a monitor.

>look under desk
You find nothing of interest.

>look at computer
You can't see any such thing.

>go below desk
You can't see any such thing.

>look
Study
The study is profoundly clean. You're very proud of how well kept this room is.

You can see a glass desk (on which is a monitor) here.

* * *

>look
Study
The study is profoundly clean. I'm very proud of how well kept this room is. The hallway is to the west.

You can see a glass desk (on which are a tiny wooden box (closed) and a monitor) and a computer key here.

>w
hallway
This hallway really needs rennovating. I mean, it's in good condition, but damn, it is outdated.

>n
You can't go that way.

>s
You can't go that way.

>e
study
The study is profoundly clean. I'm very proud of how well kept this room is.

You can see a glass desk (on which is a monitor) and a computer here.

* * *

>look
Study
The study is profoundly clean. I'm very proud of how well kept this room is. The hallway is to the west.

You can see a glass desk (on which are a tiny wooden box (closed) and a monitor) and a computer key here.

>look north
You see nothing unexpected in that direction.

>look west
You see nothing unexpected in that direction.

>look east
You see nothing unexpected in that direction.

* * *

Glulxe fatal error: The game file could not be opened. (/home/jordan/Desktop/onehourgamejam69.inform/Build/output.ulx)

[ The game has finished ]

>look at dek
You can't see any such thing.

>look at desk
This glass desk is completely transparent, and like the room overall, completely free to dust.

* * *

Glulxe fatal error: The game file could not be opened. (/home/jordan/Desktop/onehourgamejam69.inform/Build/output.ulx)

[ The game has finished ]

>look at glass desk
This glass desk is completely transparent, and like the room overall, completely free of dust.

On the glass desk is a monitor.

>look at monitor
A shiny Dell computer monitor. 24 inches of pure awesome. Great for my work and when I just want to chill with some games.

>examine
(the glass desk)
This glass desk is completely transparent, and like the room overall, completely free of dust.

On the glass desk is a monitor.

>look
Study
The study is profoundly clean. You're very proud of how well kept this room is.

You can see a glass desk (on which is a monitor) here.

* * *

Glulxe fatal error: The game file could not be opened. (/home/jordan/Desktop/onehourgamejam69.inform/Build/output.ulx)

[ The game has finished ]

>look at desk
This glass desk is completely transparent, and like the room overall, completely free of dust.

On the glass desk is a monitor.

* * *

Glulxe fatal error: The game file could not be opened. (/home/jordan/Desktop/onehourgamejam69.inform/Build/output.ulx)

[ The game has finished ]

>take computer
The computer is kinda too heavy to lift about.

* * *

Glulxe fatal error: The game file could not be opened. (/home/jordan/Desktop/onehourgamejam69.inform/Build/output.ulx)

[ The game has finished ]

>west
Upper Hallway
This hallway really needs renovating. I mean, it's in good condition, but damn, it is outdated.

Exits: east to the Study and down.

>down
Lower Hallway
Same deal with the hallways downstairs. It works, but it's in desperate need of some redecorating.

Exits: up to the Upper Hallway.

>up
Upper Hallway
This hallway really needs renovating. I mean, it's in good condition, but damn, it is outdated.

Exits: east to the Study and down to the Lower Hallway.

* * *

Glulxe fatal error: The game file could not be opened. (/home/jordan/Desktop/onehourgamejam69.inform/Build/output.ulx)

[ The game has finished ]

>take desk
That's fixed in place.

* * *

Glulxe fatal error: The game file could not be opened. (/home/jordan/Desktop/onehourgamejam69.inform/Build/output.ulx)

[ The game has finished ]

>look at box
I really don't recognise this being here. What the hell? It's a wooden box with a keyhole on the front.

>open box
It seems to be locked.

>shake box
That's not a verb I recognise.

>hit box
Violence isn't the answer to this one.

* * *

Glulxe fatal error: The game file could not be opened. (/home/jordan/Desktop/onehourgamejam69.inform/Build/output.ulx)

[ The game has finished ]

>look west
You see nothing unexpected in that direction.

>west
Hallway
This hallway really needs renovating. I mean, it's in good condition, but damn, it is outdated.

Exits: east to the Study.

>east
Study
The study is profoundly clean. I'm very proud of how well kept this room is.

You can see a glass desk (on which are a tiny wooden box (closed) and a monitor) and a computer key here.

Exits: west to the Hallway.

* * *

Glulxe fatal error: The game file could not be opened. (/home/jordan/Desktop/onehourgamejam69.inform/Build/output.ulx)

[ The game has finished ]

>look at computer
Compared to the monitor, this computer really doesn't have much power. Then again, all I use it for is writing interactive fiction and playing retro video games. The computer casing seems loose.

>look at box
I really don't recognise this being here. What the hell? It's a wooden box with a keyhole on the front.

>open computer
It isn't something you can open.

>loo at computer
That's not a verb I recognise.

* * *

Glulxe fatal error: The game file could not be opened. (/home/jordan/Desktop/onehourgamejam69.inform/Build/output.ulx)

[ The game has finished ]

>open computer
You open the computer, revealing a wooden key.

>take copper key
Taken.

>look
Study
The study is profoundly clean. I'm very proud of how well kept this room is.

You can see a glass desk (on which are a tiny wooden box (closed) and a monitor) and a computer (empty) here.

Exits: west.

>look at box
I really don't recognise this being here. What the hell? It's a wooden box with a keyhole on the front.

* * *

>open box
It seems to be locked.

>unlock box
(with the copper key)
That doesn't seem to fit the lock.

* * *

>open computer
You open the computer, revealing a wooden key.

>take key
Taken.

>open box
It seems to be locked.

>unlock box
(with the wooden key)
You unlock the tiny wooden box.

>open box
You open the tiny wooden box, revealing a steel key.

>get key
(the steel key)
Taken.

>look
Study
The study is profoundly clean. I'm very proud of how well kept this room is.

You can see a glass desk (on which are a tiny wooden box (empty) and a monitor) and a computer (empty) here.

Exits: west.

>west
Landing
This landing really needs renovating. I mean, it's in good condition, but damn, it is outdated.

You can see a steel box (closed) here.

Exits: east to the Study and down.

>open box
It seems to be locked.

>get box
Taken.

>unlock box
What do you want to unlock the steel box with?

>drop box
Dropped.

>unlock
What do you want to unlock?

>unblock steel box
You can't see any such thing.

>look
Landing
This landing really needs renovating. I mean, it's in good condition, but damn, it is outdated.

You can see a steel box (closed) here.

Exits: east to the Study and down.

>open box
It seems to be locked.

>unlock box
What do you want to unlock the steel box with?

>key
Which do you mean, the steel key or the wooden key?

>steel key
You unlock the steel box.

>look at steel box
It is a steel box. Not something I tend to leave in the hallway.

* * *

>open computer
You open the computer, revealing a wooden key.

>get key
Taken.

>unlock box
(with the wooden key)
You unlock the tiny wooden box.

>look a t box
You can't see any such thing.

>look at box
I really don't recognise this being here. What the hell? It's a wooden box with a keyhole on the front.

>look
Study
The study is profoundly clean. I'm very proud of how well kept this room is.

It's where I keep the few paper copies I need of things. Documents, bills, invoices and stuff. Need to get a replacement key for this sometime, I lost the original ages ago.

You can also see a glass desk (on which are a tiny wooden box (closed) and a monitor) and a computer (empty) here.

Exits: west.

>open box
You open the tiny wooden box, revealing a steel key.

>get steel key
Taken.

>look
Study
The study is profoundly clean. I'm very proud of how well kept this room is.

It's where I keep the few paper copies I need of things. Documents, bills, invoices and stuff. Need to get a replacement key for this sometime, I lost the original ages ago.

You can also see a glass desk (on which are a tiny wooden box (empty) and a monitor) and a computer (empty) here.

Exits: west.

>west
Landing
This landing really needs renovating. I mean, it's in good condition, but damn, it is outdated.

You can see a steel box (closed) here.

Exits: east to the Study and down.

>look at steel box
It is a steel box. Not something I tend to leave in the hallway. There seems to be a hold for a key within it.

>unlock steel box
What do you want to unlock the steel box with?

>steel key
You unlock the steel box.

>open box
You open the steel box, revealing a gold key.

>get key
Which do you mean, the gold key, the rusty key, the steel key or the wooden key?

* * *

>get key
(the steel key)
Taken.

>west
Landing
This landing really needs renovating. I mean, it's in good condition, but damn, it is outdated.

You can see a steel box (closed) here.

Exits: east to the Study and down.

>open steel box with steel key
You unlock the steel box.

>open
What do you want to open?

>box
You open the steel box, revealing a gold key.

>get gold key
Taken.

>down
Hallway
Looking good. The hallway was the first room we decorated when we moved in. Nothing crazy in here thankfully.

You can see a cupboard (closed) here.

Exits: up to the Landing.

>open cupboard
You open the cupboard, revealing a toolbox.

>open toolbox
You open the toolbox, revealing a gold box.

>open box
It seems to be locked.

>unlock
What do you want to unlock?

>gold box
What do you want to unlock the gold box with?

>gold key
You unlock the gold box.

>open box
You open the gold box, revealing a rusty key.

>get key
(the rusty key)
Taken.

>up
Landing
This landing really needs renovating. I mean, it's in good condition, but damn, it is outdated.

You can see a steel box (empty) here.

Exits: east to the Study and down to the Hallway.

>east
Study
The study is profoundly clean. I'm very proud of how well kept this room is.

You can see a filing cabinet (closed), a glass desk (on which are a tiny wooden box (empty) and a monitor) and a computer (empty) here.

Exits: west to the Landing.

>open cabinet
It seems to be locked.

>unlock
What do you want to unlock?

>cabinet
What do you want to unlock the filing cabinet with?

>rusty key
You unlock the filing cabinet.

>open cabinet
You open the filing cabinet, revealing a device.

>look at device
It's a strange black device in my filing cabinets where all my documents should be. There is *one button* on it.

The device is currently switched off.

>press button
You can't see any such thing.

>turn on device
    *** Everything fades to black. I feel I have won. ***

Would you like to RESTART, RESTORE a saved game, QUIT or UNDO the last command?

* * *

>open computer
You open the computer, revealing a wooden key.

>get keyt
You can't see any such thing.

>get key
Taken.

>open wooden box with wooden key
You unlock the tiny wooden box.

>open box
You open the tiny wooden box, revealing a steel key.

* * *

>get steel key
Taken.

>look
Study
The study is profoundly clean. I'm very proud of how well kept this room is.

You can see a filing cabinet (closed), a glass desk (on which are a tiny wooden box (empty) and a monitor) and a computer (empty) here.

Exits: west.

>west
Landing
This landing really needs renovating. I mean, it's in good condition, but damn, it is outdated.

You can see a steel box (closed) here.

Exits: east to the Study and down.

>unlock steel box with steel key
You unlock the steel box.

>open steel box
You open the steel box, revealing a gold key.

>get gold key
Taken.

>look
Landing
This landing really needs renovating. I mean, it's in good condition, but damn, it is outdated.

You can see a steel box (empty) here.

Exits: east to the Study and down.

>down
Hallway
Looking good. The hallway was the first room we decorated when we moved in. Nothing crazy in here thankfully.

You can see a cupboard (closed) here.

Exits: up to the Landing.

* * *

>open cupboard
You open the cupboard, revealing a toolbox.

>look at toolbox
My regular toolbox I've been using for all this tiring DIY work.

>open toolbox
You open the toolbox, revealing a gold box.

>unlock gold box
What do you want to unlock the gold box with?

>gold key
You unlock the gold box.

* * *

>open box
You open the gold box, revealing a rusty key.

>look at gold box
Wow, well that's shiny and definitely wasn't there before. It's another box with a keyhole.

In the gold box is a rusty key.

>get rusty key
Taken.

>up
Landing
This landing really needs renovating. I mean, it's in good condition, but damn, it is outdated.

You can see a steel box (empty) here.

Exits: east to the Study and down to the Hallway.

* * *

>east
Study
The study is profoundly clean. I'm very proud of how well kept this room is.

You can see a filing cabinet (closed), a glass desk (on which are a tiny wooden box (empty) and a monitor) and a computer (empty) here.

Exits: west to the Landing.

>open filing cabinet
It seems to be locked.

>unlock it
What do you want to unlock the filing cabinet with?

>rusty key
You unlock the filing cabinet.

>open
What do you want to open?

>cabinet
You open the filing cabinet, revealing a device.

>look at device
The device is currently switched off.

>press button
You can't see any such thing.

>press device
Nothing obvious happens.

>turn on device
    *** Everything fades to black. I feel I have won. ***

Would you like to RESTART, RESTORE a saved game, QUIT or UNDO the last command?

>press button
Please give one of the answers above.

Would you like to RESTART, RESTORE a saved game, QUIT or UNDO the last command?